11111111111111111111
10000000001000010001
100001000E1000011001
10000000000000111101
1P01110000000C000001
11111111111111111111